stagnant	침체된, 불경기의, (stagnance침체, 정체, 불황)
dramatically	극적으로
brisk	활발한, 호황의
unstable	불안정한, 변하기 쉬운
rapidly	급속히, 빨리
soar	(물가 등이)폭등하다, 높이 치솟다
assert	단언하다, 주장하다 (assertion 단언, 주장)
boost	(경기를)부양시키다, 상승시키다
analyst	분석가
potential	잠재적인
pleased	만족해하는, 기쁜
remain	계속~한 상태이다; 아직 ~해야한다
limited	제한된, 한정된
costly	비용이 많이 드는, 손실이 큰
particular	특정한, 독특한, 세심한 (partocularly 특히)
drastic	과감한, 급격한
evenly	고르게, 균등하게
evidence	증거
prospect	전망, 예상 (prospective 장래의, 미래의, 기대되는)
lead	이글다, 지휘하다; (어떤 결과에)이르다
fall	(값, 가치가)하락하다
period	기간, 시기
indicator	지표, 지수
industry	산업
likely	~할 것 같은
boom	붐, 호황
director	임원, 책임자
substitute	대용품, 대신하다(substitution 대용, 대체)
consequence	결과
fairly	상당히, 꽤
economical	경제적인, 절약되는
thrive	번영하다, 성공하다
implication	영향, 밀접한 관계 (implicate 관련시키다, 관련되었음을 나타내다)
wane	감소, 감퇴
prosperity	번영 (prosper 번영하다)
depression	불황 (depress 하락시키다, 약하게하다)
dwindle	줄어들다, 감소되다
impede	저해하다, 방해하다
promising	유망한, 전망이 좋은
adversity	역경, 불운
